{
    "exports": [
        {
            "path": "tsasm:///string_lists/status_codes_map",
            "data": {
                "metadata": {
                    "created": 1635516632440,
                    "type": "string_list",
                    "updated": 1648151007188
                },
                "values": [
                    "2002=1010",
                    "3011=3011",
                    "0001=1010",
                    "0403=1010",
                    "1011=1010",
                    "0111=1010",
                    "2001=1010",
                    "4003=1010",
                    "1004=1010",
                    "5002=5002",
                    "3010=1010",
                    "0016=1010",
                    "2003=1010",
                    "1008=1010",
                    "1040=1040",
                    "1010=1010",
                    "1005=1010",
                    "0000=0000",
                    "1007=1010",
                    "9999=9999",
                    "0014=1010",
                    "4001=1010",
                    "1002=1010",
                    "1006=1010",
                    "1000=1000",
                    "1003=1010",
                    "0011=1010",
                    "5001=5001",
                    "1001=1010",
                    "0012=1010",
                    "0013=1010",
                    "4002=1010",
                    "1009=1010",
                    "0010=0010",
                    "1012=1010"
                ],
                "id": "status_codes_map"
            },
            "category": "string_list",
            "type": "dependency",
            "constraints": [
                {
                    "server_version": "6.1.3",
                    "type": "server_version"
                }
            ],
            "dependencies": []
        }
    ]
}